11,25
+++++++++++++++++++++++++
+                       +
++++++  +++++++++++++++ +
+             +         +
+ ++++++++++++++++ ++ + +
+ +     +        + +  + +
+ + s + ++ +++++ ++++++ +
+g+   + +      +        +
+++++++ ++++++ ++++++++++
+                       +
+++++++++++++++++++++++++
